11111
1C001
1P001
111E1
11111
