111111111111111111111111111111111111111
100000000000000000101000000000000000001
101111011110111100101001111011110111101
101111C1111011110010100111101111C111101
10111101111C111100101001111C11110111101
101111011110111100101001111011110111101
100000000000000000000000000000000000001
100000000000000000000000000000000000001
100000000000000000000000000000000000001
101111011110111100101001111011110111101
10111101111C111100101001111C11110111101
101111C1111011110010100111101111C111101
101111011110111100101001111111111111111
1000000000000000001P100E00C000000000001
111111111111111111111111111111111111111
100000000000000000101000000000000000001
101111011110111100101001111011110111101
101111111110111100101001111011111111101
101111011111111100101001111111110111101
101111011110111100101001111011110111101
100000000000000000000000000000000000001
100000000000000000000000000000000000001
100000000000000000000000000000000000001
101111011110111100101001111011110111101
101111011111111100101001111111110111101
101111111110111100101001111011111111101
101111011110111100101001111011110111101
100000000000000000101000000000000000001
111111111111111111111111111111111111111